11111111111111111111111111111111111111119
12200000000000000001100000000000000002219
12200000000000000001100000000000000002219
10011111001111111001100111111100111110019
10011111001111111001100111111100111110019
10011111001111111001100111111100111110019
10000000000000000002200000000000000000019
10000000000000000002200000000000000000019
10011111001100111111111111001100111110019
10011111001100111111111111001100111110019
12200000001100000001100000001100000002219
12200000001100000001100000001100000002219
11111111001111111001100111111100111111119
11111111001111111001100111111100111111119
11111111001100000002200000001100111111119
11111111001100000002200000001100111111119
11111111001100111111111111001100111111119
11111111001100111111111111001100111111119
11111111001100111111111111001100111111119
00000000000000111111111111000000000000009
00000000000000111111111111000000000000009
11111111001100111111111111001100111111119
11111111001100000000000000001100111111119
11111111001100000000000000001100111111119
11111111001100111111111111001100111111119
11111111001100111111111111001100111111119
12200000000000000011110000000000000002219
12200000000000000011110000000000000002219
10011111111111110011110011111111111110019
10011111111111110011110011111111111110019
12200000000000000003300000000000000002219
12200000000000000003300000000000000002219
11111110011111110011110011111110011111119
11111110011111110011110011111110011111119
10000000000000110000000011000000000000019
10000000000000110000000011000000000000019
10011111111100110011110011001111111110019
12200000000000000011110000000000000002219
12200000000000000011110000000000000002219
11111111111111111111111111111111111111119
99999999999999999999999999999999999999999